FFFFFWWWFFFFWWW
FWWWFWWFFWWFWWW
FFWFFWWFWWWFFFF
WWWFWWWFFWWFWWF
WFWFFFFFFWWFWWF
FFFWWWWWWWWFWWF
FWFFFFWWFWWFWWF
FWWWWFFFFFFFWWF
FWFFFWWWWWWFFFF
FFFWFWFFFFWFWWW
FWWWWWFWWFWFFFF
FFFFFFFWWFWWWWF
WFWWWWWWWWWWWFF
WFWFFFFWFFFWFWW
WFFFWWFFFWFFFFE
