FFFFFWWWFFFFWWW
FWWWFWWFFWWFWWW
FFWFFWWFWWWFFFF
WWWFWWWFFWWFWWF
WFWFFFFFFWWFWWF
FFFWWWWWWWWFWWF
FWFFFFWWFWWFWWF
FWWWWFFFFFFFWWF
FWFFFWWWWWWFFFF
FFFWFWFFFFWFWWW
FWWWWWFWWFWFFFF
FFFFFFFWWFWWFWW
WFWWWWWWWWWFFWW
WFWFFFFWFFFWWWW
WFFFWWFFFWFFFFE
